########
#S.....#
#.###..#
#...#G.#
########
