############
#S...#.....#
###.#.###..#
#...#...#..#
#.#####.#G##
#.........##
############
